G G S S G G G G G G G G G G G G G G G G
G G S S G G G G G G G G G G G G G G G G
G G S S G G G G G G G G G G G G G G G G
G G S S G G G G G G G G G G G G G G G G
G G S S G G G G G G G G G G G G G G G G
G G S S S S S S S S S S G G G G G G G G
G G S S S S S S S S S S G G G G G G G G
G G S S G G G G G G S S G G G G G G G G
G G S S G G G G G G S S G G G G G G G G
G G S S G G G G G G S S G G G G D D D D
G G S S G G G G G G S S G G D D D W W W
G G S S G G G G G G S D D D D D W W W W
G G S S G G G G D D D D D W W W W W W W
G G S S G G G D D W W W W W W W W W W W
G G S S G G G D W W W W W W W W W W W W
