G D D D G G W W W W W W W W W W W W W W
G D D D G G W W W W W W W W W W W W W W
G D D D G G G W W W W W W W W W W W W W
G D D D G G G G G G W W W W W W W W W W
G D D D D D D D D G G G G W W W W W W W
G D D D D D D D D D D G G G G W W W W W
G D D D D D D D D D D D G G G G W W W W
G D D D G G G G G D D D D G G G G W W W
G D D D G G W G G G D D D G G G G G G W
G D D D G G W G G G G D D D G G G G G G
G D D D D G W W G G G D D D D D G G G G
G D D D D G G W W G G G D D D D D D D G
G G D D D G G W W W W G G D D D D D D D
G G D D D D G G W W W W G G G G D D D D
G G D D D D G G W W W W W W G G G G D D
