G D D D G G W W W W W W W W W W W W W W W W W W
G D D D G G W W W W W W W W W W W W W W W W W W
G D D D G G G W W W W W W W W W W W W W W W W W
G D D D G G G G G G W W W W W W W W W W W W W W
G D D D D D D D D G G G G W W W W W W W W W W W
G D D D D D D D D D D G G G G W W W W W W W W W
G D D D D D D D D D D D G G G G W W W W W W W W
G D D D G G G G G D D D D G G G G W W W W W W W
G D D D G G W G G G D D D G G G G G G W W W W W
G D D D G G W G G G G D D D G G G G G G G G G G
G D D D D G W W G G G D D D S S G G G G G G G G
G D D D D G G W W G G G D S D S S S S G G G G G
G G D D D G G W W W W G G D S S S S S S S S S S
G G D D D D G G W W W W G G G G S S S S S S S S
G G D D D D G G W W W W W W G G G G S S S S S S
G G G D D D G G W W W W W W G G G G G G G G G G
G G G D D D G G W W W W W W W G G G G G G G G G
G G G D D D G G W W W W W W W G G G G G G G G G
G G G D D D G G W W W W W W W G G G G G G G G G
G G G D D D G G W W W W W W W W G G G G G G G G
G G G D D D G G G W W W W W W W G G G G G G G G
G G G D D D G G G G W W W W W W G G G G G G G G
G G G D D D G G G G G W W W W G G G G G G G G G
G G G D D D G G G G G G W W G G G G G G G G G G
G G G D D D G G G G G G G G G G G G G G G G G G
