G G G G D D D G G G G G G G G G G G G G G G G G G G G G G G G G G G G G G G G G G G G G G G G G
G G G G D D D G G G G G G G G G G G G G G G G G G G G G G G G G G G G G G G G G G G G G G G G G
G G G G D D D G G G G G G G G G G G G G G G G G G G G G G G G G G G G G G G G G G G G G G G G G
G G G G D D D G G G G G G G G G G G G G G G G G G G G G G G G G G G G G G G G G G G G G G G G G
G G G G D D D G G G G G G G G G G G G G G G G G G G G G G G G G G G G G G G G G G G G G G G G G
G G G G D D D G G G G G G G G G G G G G G G G G G G G G G G G G G G G G G G G G G G G G G G G G
G G G G D D D G G G G G G G G G G G G G G G G G G G G G G G G G G G G G G G G G G G G G G G G G
G G G G G D D G G G G G G G G G G G G G G G G G G G G G G G G G G G G G G G G G G G G G G G G G
G G G G G D D D G G G G G G G G D D D D D G G G G G G G G G G G G G G G G G G G G G G G G G G G
G G G G G D D D D G G G G G D D D D D D D D G G G G G G G G G G G G G G G G G G G G G G G G G G
G G G G G G D D D D G G D D D D D D D D D D D D G G G G G G G G G G G G G G G G G G G G G G G G
G G G G G G G D D D D D D D D D D D G G D D D D D G G G G G G G G G D G G G G G G G G G G G G G
G G G G G G G G D D D D D D G G G G G G G G D D D D D G G G G G G G D D G G G G G G G G G G G G
G G G G G G G G D D D D D D G G G G G G G G G D D D D G G G G G G G D D G G G G G G G G G G G G
G G G G G G G G G G D D S S S G G G G G G G G G G D D D G G G G G G D D G G G G G G G G G G G G
G G G G G G G G G G G S S S S W W W W W G G G G G G D D G G G G G G D D G G G G G G G G G G G G
G G G G G G G G W W W W S S S W W W W W W W G G G G D D D G G G G D D D G G G G G G G G G G G G
G G G G G G G W W W W W W S S S W W W W W W G G G D D D D G G G D D D D D G G G G G G G G G G G
G G G G G G G W W W W W W W S S W W W W W W G G G D D D D D D D D D D D D D D G G G G G G G G G
G G G G G G G W W W W W W W S S S W W W W G G G D D D D D D D D D D D D D D D D D D D G G G G G
G G G G G G W W W W W W W W W S S S S S S S D D D D D D D D D D D D D D D D D D D D D D D D D D
G G G G G G W W W W W W W W W W S S S S S S S D D D D D D D D D D D G G G G D D D D D D D D D D
G G G G G G W W W W W W W W W W W W W W S S S D D D D G G G G G G G G G G G G G G G D D D D D D
G G G G G G G W W W W W W W W W W W W W W W G G G D D D G G G G G G G G G G G G G G G G G G G G
G G G G G G G W W W W W W W W W W W W W W W G G G D D D G G G G G G G G G G G G G G G G G G G G
G G G G G G G G W W W W W W W W W W W W W G G G G D D D G G G G G G G G G G G G G G G G G G G G
G G G G G G G G G W W W W W W W W W W W G G G G G D D D G G G G G G G G G G G G G G G G G G G G
G G G G G G G G G G G G W W W W W W W G G G G G G D D D D G G G G G G G G G G G G G G G G G G G
G G G G G G G G G G G G G G G G G G G G G G G G G D D D D G G G G G G G G G G G G G G G G G G G
G G G G G G G G G G G G G G G G G G G G G G G G G G D D D D G G G G G G G G G G G G G G G G G G
G G G G G G G G G G G G G G G G G G G G G G G G G G G D D G G G G G G G G G G G G G G G G G G G
G G G G G G G G G G G G G G G G G G G G G G G G G G G G G G G G G G G G G G G G G G G G G G G G
