G G D D S S W W G G G D S G G G G G G G G G G G G G G G G G G G G G G G G G G G G G G
G G D D S S W W G G G D S G G G G G G G G G G G G G G G G G G G G G G G G G G G G G G
G G G G G G G G G G G D S G G G G G G G G G G G G G G G G G G G G G G G G G G G G G G
G G G G G G G G G G G D S G G G G G G G G G G G G G G G G G G G G G G G G G G G G G G
G G G G G G G G G G G D S G G G G G G G G G G G G G G G G G G G G G G G G G G G G G G
W W G G W W W W W G G D S G W W W W W W W W W W W W W W W W W W W W W W W W W W W W W
W S G G W S W S W G G D S G W S W S W S W S W S W S W S W S W S W S W S W S W S W S W
S W G G S W S W S G G D S G S W S W S W S W S W S W S W S W S W S W S W S W S W S W S
W W G G W W W W W G G D S G W W W W W W W W W W W W W W W W W W W W W W W W W W W W W
G G G G G G G G G G G D S G G G G G G G G G G G G G G G G G G G G G G G G G G G G G G
G G G G G G G G G G G D S G G G G G G G G G G G G G G G G G G G G G G G G G G G G G G
G G G G G G G G G G G D S G G G G G G G G G G G G G G G G G G G G G G G G G G G G G G
G G G G G G G G G G G D S G G G G G G G G G G G G G G G G G G G G G G G G G G G G G G
G G G G G G G G G G G D S G G G G G G G G G G G G G G G G G G G G G G G G G G G G G G
G G G G G G G G G G G D S G G G G G G G G G G G G G G G G G G G G G G G G G G G G G G
G G G G G G G G G G G D S G G G G G G G G G G G G G G G G G G G G G G G G G G G G G G
G G G G G G G G G G G D S G G G G G G G G G G G G G G G G G G G G G G G G G G G G G G
G G G G G G G G G G G D S G G G G G G G G G G G G G G G G G G G G G G G G G G G G G G
G G G G G G G G G G G D S G G G G G G G G G G G G G G G G G G G G G G G G G G G G G G
G G G G G G G G G G G D S G G G G G G G G G G G G G G G G G G G G G G G G G G G G G G
